1111111111111111111111111111111111
1010000100000000101000000000000101
1010010100100M0010100100M000010101
1E0000000000000C00000C000000000001
10100101001000M010100100000M010101
1010010010101010001001000M00010101
1P0000000C00C0000M000000000M0000C1
1010010100000000101001000000010101
1010000100100M0010000000M000010101
101000010010000000M00100000M000101
1111111111111111111111111111111111