1111111111111111111111111111111111
1010000100000000101000000000000001
1010010100100M001010010000100C0001
1E0000000000000C00000C000010000001
10100101001000M0101001000011111111
1010010010101010P01001000M00010101
100000000C00C0000M000000000M0000C1
1010010100000000101001000000000101
101C000100100M0010000000M000010101
101000010010000000M00100000M000101
1111111111111111111111111111111111