11111111
10000001
1000M001
10000001
1000C001
10000001
1000E001
10000001
11111111